project,annotation_question,num_reviews_yes,num_reviews_no,annotator_id,num_annotated_reviews,avg_lead_time_annotator_in_s,avg_agreement_annotator
Mortal Kombat 11,is-review-bombing,8,7,9365,15,34.64,89.26
Mortal Kombat 11,criticism-praise-developer-publisher,8,7,9365,15,34.64,89.26
Mortal Kombat 11,criticism-praise-political,2,13,9365,15,34.64,89.26
Mortal Kombat 11,is-rating-game-related,15,0,9365,15,34.64,89.26
Mortal Kombat 11,criticism-praise-game-content,15,0,9365,15,34.64,89.26
Mortal Kombat 11,criticism-praise-ideological,4,11,9365,15,34.64,89.26
Mortal Kombat 11,criticism-praise-developer-publisher,19,11,9368,30,38.13,96.11
Mortal Kombat 11,is-review-bombing,22,8,9368,30,38.13,96.11
Mortal Kombat 11,criticism-praise-game-content,20,10,9368,30,38.13,96.11
Mortal Kombat 11,criticism-praise-ideological,16,14,9368,30,38.13,96.11
Mortal Kombat 11,criticism-praise-political,2,28,9368,30,38.13,96.11
Mortal Kombat 11,is-rating-game-related,8,22,9368,30,38.13,96.11
Mortal Kombat 11,criticism-praise-ideological,28,7,9627,35,46.23,100.0
Mortal Kombat 11,criticism-praise-developer-publisher,15,20,9627,35,46.23,100.0
Mortal Kombat 11,is-review-bombing,23,12,9627,35,46.23,100.0
Mortal Kombat 11,criticism-praise-political,1,34,9627,35,46.23,100.0
Mortal Kombat 11,is-rating-game-related,24,11,9627,35,46.23,100.0
Mortal Kombat 11,criticism-praise-game-content,23,12,9627,35,46.23,100.0
Mortal Kombat 11,criticism-praise-developer-publisher,9,11,9754,20,23.91,81.67
Mortal Kombat 11,criticism-praise-political,1,19,9754,20,23.91,81.67
Mortal Kombat 11,is-review-bombing,11,9,9754,20,23.91,81.67
Mortal Kombat 11,criticism-praise-ideological,12,8,9754,20,23.91,81.67
Mortal Kombat 11,is-rating-game-related,19,1,9754,20,23.91,81.67
Mortal Kombat 11,criticism-praise-game-content,16,4,9754,20,23.91,81.67
Mortal Kombat 11,criticism-praise-political,4,16,10389,20,35.95,100.0
Mortal Kombat 11,is-review-bombing,6,14,10389,20,35.95,100.0
Mortal Kombat 11,criticism-praise-game-content,18,2,10389,20,35.95,100.0
Mortal Kombat 11,criticism-praise-developer-publisher,7,13,10389,20,35.95,100.0
Mortal Kombat 11,criticism-praise-ideological,8,12,10389,20,35.95,100.0
Mortal Kombat 11,is-rating-game-related,17,3,10389,20,35.95,100.0
Mortal Kombat 11,criticism-praise-ideological,2,14,11478,16,51.59,64.58
Mortal Kombat 11,is-rating-game-related,5,11,11478,16,51.59,64.58
Mortal Kombat 11,criticism-praise-political,4,12,11478,16,51.59,64.58
Mortal Kombat 11,criticism-praise-developer-publisher,14,2,11478,16,51.59,64.58
Mortal Kombat 11,criticism-praise-game-content,10,6,11478,16,51.59,64.58
Mortal Kombat 11,is-review-bombing,12,4,11478,16,51.59,64.58
Mortal Kombat 11,is-rating-game-related,28,1,11790,29,46.99,66.67
Mortal Kombat 11,criticism-praise-ideological,19,10,11790,29,46.99,66.67
Mortal Kombat 11,is-review-bombing,14,15,11790,29,46.99,66.67
Mortal Kombat 11,criticism-praise-political,3,26,11790,29,46.99,66.67
Mortal Kombat 11,criticism-praise-game-content,20,9,11790,29,46.99,66.67
Mortal Kombat 11,criticism-praise-developer-publisher,18,11,11790,29,46.99,66.67
Mortal Kombat 11,criticism-praise-developer-publisher,9,21,13430,30,27.44,70.0
Mortal Kombat 11,criticism-praise-game-content,30,0,13430,30,27.44,70.0
Mortal Kombat 11,criticism-praise-ideological,21,9,13430,30,27.44,70.0
Mortal Kombat 11,is-rating-game-related,12,18,13430,30,27.44,70.0
Mortal Kombat 11,criticism-praise-political,7,23,13430,30,27.44,70.0
Mortal Kombat 11,is-review-bombing,23,7,13430,30,27.44,70.0
Mortal Kombat 11,is-review-bombing,30,30,15655,60,29.74,100.0
Mortal Kombat 11,criticism-praise-developer-publisher,16,44,15655,60,29.74,100.0
Mortal Kombat 11,criticism-praise-ideological,5,55,15655,60,29.74,100.0
Mortal Kombat 11,criticism-praise-political,8,52,15655,60,29.74,100.0
Mortal Kombat 11,is-rating-game-related,60,0,15655,60,29.74,100.0
Mortal Kombat 11,criticism-praise-game-content,57,3,15655,60,29.74,100.0
Mortal Kombat 11,criticism-praise-game-content,14,1,15657,15,36.81,100.0
Mortal Kombat 11,is-rating-game-related,13,2,15657,15,36.81,100.0
Mortal Kombat 11,criticism-praise-developer-publisher,3,12,15657,15,36.81,100.0
Mortal Kombat 11,criticism-praise-political,5,10,15657,15,36.81,100.0
Mortal Kombat 11,criticism-praise-ideological,7,8,15657,15,36.81,100.0
Mortal Kombat 11,is-review-bombing,10,5,15657,15,36.81,100.0
Mortal Kombat 11,criticism-praise-political,3,27,16195,30,37.6,96.11
Mortal Kombat 11,is-rating-game-related,21,9,16195,30,37.6,96.11
Mortal Kombat 11,criticism-praise-developer-publisher,15,15,16195,30,37.6,96.11
Mortal Kombat 11,is-review-bombing,10,20,16195,30,37.6,96.11
Mortal Kombat 11,criticism-praise-game-content,26,4,16195,30,37.6,96.11
Mortal Kombat 11,criticism-praise-ideological,8,22,16195,30,37.6,96.11
Mortal Kombat 11,is-review-bombing,4,11,17568,15,13.8,74.44
Mortal Kombat 11,criticism-praise-game-content,10,5,17568,15,13.8,74.44
Mortal Kombat 11,criticism-praise-political,1,14,17568,15,13.8,74.44
Mortal Kombat 11,is-rating-game-related,11,4,17568,15,13.8,74.44
Mortal Kombat 11,criticism-praise-ideological,8,7,17568,15,13.8,74.44
Mortal Kombat 11,criticism-praise-developer-publisher,7,8,17568,15,13.8,74.44
Mortal Kombat 11,criticism-praise-ideological,15,0,17629,15,36.02,78.52
Mortal Kombat 11,criticism-praise-political,2,13,17629,15,36.02,78.52
Mortal Kombat 11,criticism-praise-developer-publisher,12,3,17629,15,36.02,78.52
Mortal Kombat 11,criticism-praise-game-content,14,1,17629,15,36.02,78.52
Mortal Kombat 11,is-review-bombing,9,6,17629,15,36.02,78.52
Mortal Kombat 11,is-rating-game-related,13,2,17629,15,36.02,78.52
Mortal Kombat 11,is-rating-game-related,25,10,17750,35,30.73,87.14
Mortal Kombat 11,criticism-praise-developer-publisher,28,7,17750,35,30.73,87.14
Mortal Kombat 11,criticism-praise-political,16,19,17750,35,30.73,87.14
Mortal Kombat 11,criticism-praise-ideological,4,31,17750,35,30.73,87.14
Mortal Kombat 11,criticism-praise-game-content,32,3,17750,35,30.73,87.14
Mortal Kombat 11,is-review-bombing,20,15,17750,35,30.73,87.14
Mortal Kombat 11,criticism-praise-ideological,10,0,17758,10,86.27,100.0
Mortal Kombat 11,criticism-praise-political,2,8,17758,10,86.27,100.0
Mortal Kombat 11,criticism-praise-game-content,10,0,17758,10,86.27,100.0
Mortal Kombat 11,is-review-bombing,7,3,17758,10,86.27,100.0
Mortal Kombat 11,is-rating-game-related,10,0,17758,10,86.27,100.0
Mortal Kombat 11,criticism-praise-developer-publisher,4,6,17758,10,86.27,100.0
Mortal Kombat 11,criticism-praise-political,8,22,17811,30,16.78,78.33
Mortal Kombat 11,criticism-praise-ideological,10,20,17811,30,16.78,78.33
Mortal Kombat 11,criticism-praise-game-content,27,3,17811,30,16.78,78.33
Mortal Kombat 11,is-rating-game-related,26,4,17811,30,16.78,78.33
Mortal Kombat 11,is-review-bombing,7,23,17811,30,16.78,78.33
Mortal Kombat 11,criticism-praise-developer-publisher,16,14,17811,30,16.78,78.33
Mortal Kombat 11,criticism-praise-game-content,15,0,17911,15,50.31,100.0
Mortal Kombat 11,is-rating-game-related,15,0,17911,15,50.31,100.0
Mortal Kombat 11,criticism-praise-ideological,14,1,17911,15,50.31,100.0
Mortal Kombat 11,criticism-praise-political,0,15,17911,15,50.31,100.0
Mortal Kombat 11,criticism-praise-developer-publisher,6,9,17911,15,50.31,100.0
Mortal Kombat 11,is-review-bombing,12,3,17911,15,50.31,100.0
Mortal Kombat 11,is-review-bombing,3,12,18232,15,55.17,74.44
Mortal Kombat 11,criticism-praise-political,3,12,18232,15,55.17,74.44
Mortal Kombat 11,criticism-praise-ideological,5,10,18232,15,55.17,74.44
Mortal Kombat 11,criticism-praise-developer-publisher,6,9,18232,15,55.17,74.44
Mortal Kombat 11,is-rating-game-related,14,1,18232,15,55.17,74.44
Mortal Kombat 11,criticism-praise-game-content,13,2,18232,15,55.17,74.44
Mortal Kombat 11,is-review-bombing,11,19,18236,30,40.67,78.15
Mortal Kombat 11,criticism-praise-political,5,25,18236,30,40.67,78.15
Mortal Kombat 11,criticism-praise-ideological,12,18,18236,30,40.67,78.15
Mortal Kombat 11,criticism-praise-game-content,25,5,18236,30,40.67,78.15
Mortal Kombat 11,criticism-praise-developer-publisher,24,6,18236,30,40.67,78.15
Mortal Kombat 11,is-rating-game-related,20,10,18236,30,40.67,78.15
Mortal Kombat 11,is-rating-game-related,20,0,18248,20,34.14,85.28
Mortal Kombat 11,is-review-bombing,11,9,18248,20,34.14,85.28
Mortal Kombat 11,criticism-praise-ideological,2,18,18248,20,34.14,85.28
Mortal Kombat 11,criticism-praise-game-content,20,0,18248,20,34.14,85.28
Mortal Kombat 11,criticism-praise-political,0,20,18248,20,34.14,85.28
Mortal Kombat 11,criticism-praise-developer-publisher,10,10,18248,20,34.14,85.28
Mortal Kombat 11,criticism-praise-game-content,15,0,18440,15,28.82,62.22
Mortal Kombat 11,criticism-praise-developer-publisher,11,4,18440,15,28.82,62.22
Mortal Kombat 11,is-rating-game-related,15,0,18440,15,28.82,62.22
Mortal Kombat 11,is-review-bombing,6,9,18440,15,28.82,62.22
Mortal Kombat 11,criticism-praise-ideological,15,0,18440,15,28.82,62.22
Mortal Kombat 11,criticism-praise-political,3,12,18440,15,28.82,62.22
